10
10

W,W,W,W,W,W,W,W,W,W
W,F,F,F,J,F,F,S,F,W
W,F,F,S,F,F,F,F,F,W
W,F,F,F,F,F,C,F,F,W
W,F,C,F,W,Q,J,F,F,W
W,F,J,Q,F,J,S,F,F,W
W,F,F,W,F,F,F,F,F,W
W,F,F,F,Q,C,Q,F,F,W
W,F,S,F,F,F,J,F,F,W
W,W,W,W,W,W,W,W,W,W

n,n,n,n,n,n,n,n,n,n
n,A,D,n,n,n,D,n,n,n
n,n,n,n,n,K,n,D,n,n
n,D,n,n,n,n,n,n,n,n
n,n,n,n,n,D,n,n,n,n
n,n,n,n,n,n,n,n,n,n
n,n,n,n,n,n,n,K,n,n
n,D,K,n,n,n,n,n,n,n
n,n,n,D,n,n,n,D,B,n
n,n,n,n,n,n,n,n,n,n

C;3,6;7,2
C;4,2;6,7
C;7,5;2,5
S;1,7;7,6
S;2,3;5,3
S;5,6;4,5
S;8,2;7,4