10
10

W,W,W,W,W,W,W,W,W,W
W,J,F,F,C,F,F,F,J,W
W,F,F,F,F,F,F,F,F,W
W,F,F,F,F,F,F,F,F,W
W,F,F,F,F,F,F,F,F,W
W,C,F,F,F,F,F,F,C,W
W,F,F,F,F,F,F,F,F,W
W,F,F,F,F,F,F,F,F,W
W,J,F,F,C,F,F,F,J,W
W,W,W,W,W,W,W,W,W,W

n,n,n,n,n,n,n,n,n,n
n,n,D,n,D,n,D,n,n,n
n,D,n,D,n,D,n,D,n,n
n,n,D,n,K,n,D,n,D,n
n,B,n,K,n,K,n,D,A,n
n,n,D,n,K,n,D,n,D,n
n,D,n,D,n,D,n,D,n,n
n,n,D,n,D,n,D,n,D,n
n,n,n,D,n,D,n,D,n,n
n,n,n,n,n,n,n,n,n,n

C;1,4;3,4
C;5,1;4,3
C;5,8;5,4
C;8,4;4,5