10
10

W,W,W,W,W,W,W,W,W,W
W, , ,C,J,C, , , ,W
W, , ,S,J,S, , , ,W
W, , , ,Q, , , , ,W
W,C,J,Q,W,Q,J,J,J,W
W, , , ,Q, , , , ,W
W, , ,S,J,S, , , ,W
W, , , ,J, , , , ,W
W, , ,C,J,C, , ,,W
W,W,W,W,W,W,W,W,W,W

n,n,n,n,n,n,n,n,n,n
n,n,n,n,n,n,n,n,n,n
n,n,D,n,n,n,D,n,n,n
n,n,n,K,n,K,n,n,n,n
n,n,n,n,n,n,n,n,n,n
n,n,n,n,n,n,n,n,n,n
n,n,K,n,n,n,n,K,n,n
n,n,D,n,n,n,n,D,n,n
n,A,n,n,n,n,n,n,B,n
n,n,n,n,n,n,n,n,n,n

C;1,3;6,2
C;1,5;6,7
C;8,3;3,3
C;8,5;3,5
S;2,3;4,3
S;2,5;3,4
S;6,3;5,4
S;6,5;4,5